       R              1920          3080    
NO      ./path_to_the_north_texture           
      SO ./path_to_the_south_texture




WE ./path_to_the_west_texture
EA                                    ./path_to_the_east_texture

S ./_path_to_the_sprite_texture


    F   255,   300    ,     9    
C 225,               30,      1


                   111111111111111111111111
                   100000000011001100110001
                   100001000000010001100101
                   100000000000000000000001
1111111111111111111101111000000000001100111vertrytsetyseyBONJOUR
1000000000000000000000000000000000000000001
1000000000001110000000011111111111110000001
1111111111111 1111111111 111111111111000001
1000000000011111111111111111111111110000001
1000000000000000000000000000000000000000001
1000000000000000000000000000000000000000001
10000000000000000000000N0000000000000000001
1000000000000000000000000000000000000000001
1111111111111111111111111111111111111111111