       R              800          600    
NO      ./srcs/textures/wall1.xpm          
      SO ./srcs/textures/wall2.xpm




WE ./srcs/textures/wall3.xpm
EA                                    ./srcs/textures/wall4.xpm

S ./srcs/textures/barrel.xpm


    F   255,   300    ,     9    
C 225,               30,      1


                   111111111111111111111111
                   100000000011001100110001
                   100001000000010001100101
                   100000000020000000000001
1111111111111111111001111000000000001100111
1000000000000000000000000000000000000000001
1000000000001110000000011111111111110000001
1111111111111 1111111111 111111111111000001
1000000000011111111111111111111111110000001
1000000000000000000000000000000000000000001
1000000200000000000000000000000000000000001
10000002000000000000000W0000000000000000001
1000000000000000000000000000000000000000001
1111111111111111111111111111111111111111111