 
R  640 500

NO  ./texture/colorstone.XPM    
 
SO ./texture/wood.XPM       
WE ./texture/greystone.XPM     
EA ./texture/mossy.XPM  

C 111,222,1000
S ./texture/barrel.XPM 
F 51,    322    ,    1404


 11111111


111 111211
111000111011000111100011002
1000000001111100000
1   000000000  10000000000000000111
   0     00000 001000000000011100110001000001
     0000S1111111111111111100000000000000
  0000000000000000000 0000000000
100 0000       00001000011
      11  0000000      0000000000000000000001
111000  00000000000000000      11011
      00000  011100
    1111011100000000001101
1000000001000020100101001110100001
2   1111111111111111111111111