11111       8   
10001
10001
10001
11111
