
 
   R       800                 600     
NO     ./srcs/textures/wall1.xpm          
      SO ./srcs/textures/wall2.xpm   

  F       255,   255  ,  245

   
    WE    ./srcs/textures/wall3.xpm


C 225  ,              131,      30 
EA                                    ./srcs/textures/wall4.xpm

S      ./srcs/textures/barrel.xpm

  


 
1111111111 11111111111111111
1                           1
100000000000000000000000000000000
1111111111111111N              211
1111111111111111111111111111111111

  
 
 