      R              1920          3080    
NO      ./path_to_the_north_texture           
      SO ./path_to_the_south_texture




WE ./path_to_the_west_texture
EA                                    ./path_to_the_east_texture

S ./_path_to_the_sprite_texture


    F   255,   300    ,    9    
C 225,               30,      1


111111
100001
1N0021
1  111
1111111

