      
    R   800 600 
 NO      ./srcs/textures/wall1.xpm
                SO ./srcs/textures/wall2.xpm 


            WE     ./srcs/textures/wall3.xpm   
EA                                    ./srcs/textures/wall4.xpm         

    
              S                                        ./srcs/textures/barrel.xpm 

  C   50, 70, 140

                                                
    F  78,   69    ,     67     



                   111111111111111111111111
                   100000000011001100110001
                   100001000100010001100101
                   100000000020000000000001
1111100000001111111001111000000000001100111
1000000000000000000000000000000000000000001       
1000000000001110000000011111111111110000001
1110011111111 1111111111 11111111111100001 1
1000000000011111111111111111111111110000001
1222222222222222222222222222222222220000001111111111111
1000000200000000000000000000000000000000000000000000001
100000020000000000E00000000000000000000000111111101111
1000000000000000000000000000000000000000001     101
1111101111110110011110000111111111101111111     101
1    01100011111111110000001      10111111111111101
1    0000101110000000020021       10000000000000001
1         01110111111111111       11111111111111111
1        0000001
1111111111111111



